R 800 801
SO ./textures/wood.png
EA ./textures/colorstone.png           
NO ./textures/redbrick.png
WE ./textures/mo ssy.png
S ./textures/thing.png
C 0,255,0    
F 255,0,255        

        1111111111111111111111111
        1000000000110000000000001      111
        1011000001110000002000001      101
        1001000000000000000000001      101
111111111011000001110000000000001      111
100000000011000001110111111111111
11110111111111011100000010001
11110111111111011101010010001
11000001110101011100000010001
10002000000000001100000010001               11111
100000000N0000001101010000001               10201
11000001110101011111011110001               11111
11110111 1110101 101111010001
11111111 1111111 111111111111