R 600 600
NO img/cobblestone.png
SO img/cobblestone.png
EA img/cobblestone.png
WE  img/cobblestone.png

C 255,0,0
F 255,255,255
S img/thenun.cub

111111111111111111111111111111
11000000100000010000001N000001
10001000000100000001111000011111
10011100110010011100000100000001
10011100110010011100000111111101
10011100110000000000111100000101
100111111100000000001001     111
100111111100111111N01001
100000000000100100011111
10000000000010010001
10011111111110010011
100000000010000100011111
100000000010000100000001
101111110010011100001001
101111110010010000001001
100000010010010011111001
100011011110010011000001
101111010110010011000001
101111000110000011001001
101111110110000011001001
111000000110011111001001
100000010110000000001001
111000010010000000001001
111111111111111111111111