R 1200 800
NO textures/greystone.png
EA textures/greystone.png
SO textures/greystone.png
WE textures/greystone.png
S textures/greystone.png

C 0,0,0
F 0,0,0
11111111111111111111111111111
12222222221100000000000000001
10110000011100000000000010001
10010000000000000000100000001
10110000011100000000000010001
10000000001100000111011110001
11110111111111011100000010001
11110111111111011101010010201
11000000110101011100000010001
10000000000000001100000010001
10000000000000001101010000001
11000000110101011111011110N01
11110111111101011111011110001
11111111111111111111111111111