C 0,0,255
F 255,0,0

R 400 400
NO ./textures/redbrick.png
EA ./textures/bluestone.png
SO ./textures/file3.xpm
WE ./textures/mossy.png
S ./textures/barrel.png
                                                                       111111111111        11111111 
                                                                      10000000000001     11000000001
                                                                     100000000000001    101000000001
                                                                   110000000000000001   10000000001 
                                                                  10000000000000000001  10000010001 
                                                                 100000000000000010001   10001 10001
                                                                  1100000000000000001    10001100001
                                                                    10000000000000001     1001000001
                                                                   100000000000000001     1000000001
                                                                   1000000000000001011   11000000001
                                                                    1110010000000000001 100100000021
                                                                      100000000000001011000000010101
                                                                      101000110000010001001000000001
                                                                      10000001101111010000000000001 
                                                                      1001000111    1 1S111100000001
                                                                       11 1000001      1    11000001
                                                                          1000001             110001
                                                                           10001               10001
                                                                           10111               1001 
                                                                           100001               11  
                                                                            11101                   
                                                                              1001                  
                                                                             10001                  
                                                                              1001                  
                                                                              1001                  
                                                                              101                   
                                                                              101                   
                                                                   11  1      1001                  
                                                                  1001101     10001                 
                                                                   100001     1001                  
                                                                   100011111111001                  
                                                                   100000000000001                  
                                                                   110011110011001                  
                                                                  100001   11  11                   
                                                                 10000001                           
                                                               1100000001                           
                                                              1000000001                            
                                                         11   100000001                             
                                                        1001   1000001                              
                                                       10000111000011                               
                                                       100000010001                    11           
                                                       100000000001      1        11  1001 1        
                                                       100000000001    1101      1001 1001101       
                                                        1110001011    100011   11100110000001       
                                                          1001 11     10000011100000000000001       
                                                         100001001     1000210000000010000001       
                                                         1000010001    10010000000000000000001      
                                                          110110001     1010000010110000010011      
                                                           10010001     10000000000000000000001     
                                                            101000011    1010000000000000000011     
                                                           10000000001  110000002000000000000001    
                                                           10000000001 100100000000000000000201     
                                                            110000000011000000000000000001000001    
                                                            1000000000010000000000000000000000001   
                                                             10000000001100000000000000000000011    
                                                              100000000100000000000000000000001     
                                                               1100000010000000000000000001111      
                                                                100000110010000000000000001         
                                                                100000111000020000000000001         
                                                                100000100000000000001111101         
                                                               11100000000000000000100010001        
                                                              1000000000000002000001000000001    11 
                                                            1101000001000000000000110000011011111001
                                                           100000001010000000000001110111 1000000001
                                                          10000000000111111100000010001    110000001
                                                           110000000001   1110000110101     1000011 
                                                            10100100001111000000000011      10001   
                                                             11000000000000000100011       10011    
                                                            100000000002000000110001        101     
                                                             1000000000111000000001      111001     
                                                             101000000001100010001      100001      
                                                            1001000000000000000001     11000001     
                                                           1000000000000000000000111  1000000001    
                                                           1010000000000000010000000111000000001    
                                                            1 10000000000001 1011110000001000001    
                                                              100000100000001 1  1000011000000001   
                                                              10000000000011     10001  1010000001  
                                                             100000010000001     10001  1010000011  
                                                            1000010110000001     10001 100100000001 
                                                            1000001110000001    10011 1000000000001 
                                                            1011100000000001    1001111110111100201 
                                                      11     110000001000001    10000000001   11201 
                                                   111001     10000011100001     111111111      11  
                                                  1000001      100100010111                         
                                                 11000011     1001 110101                           
                                                1000000001   10001  10001                           
                                               1100000000011110001   111                            
                                              1000010000000000001                                   
                                             10000000000000000001                                   
                                             10000000000000000001                                   
                                        1    10000000000000000001                                   
                                      110111 10000000000000000001                                   
                                     1000000100000000000000000001                                   
                                  111000000010200000000010000011                                    
                                 100000000011100000000000000001                                     
                                 100000000000111000000010000001                                     
                                  1000000020011100000001001111                                      
                                 10000000000000110000000001                                         
                                  1010000000000000000000001                                         
                                   1 111111111111111111111                                          