SO ./textures/file3.xpm
EA ./textures/bluestone.png
      C      01,0,255
      F       255,0,0      

      R 400 400
NO       ./textures/redbrick.png
      WE       ./textures/mossy.png
S ./textures/barrel.png                            

111111
100001
1000001
1000001
1E000001
1000001
1000001
100001
11111