R 800 800
NO textures/file1.xpm
EA textures/file2.xpm
SO textures/file3.xpm
WE textures/wood.png
S textures/pixil-frame-0.png

C 135,206,235
F 168, 119, 90
                                                                                    11                         11111111111 1  11111111111                                                               
                                                                                  11001                       1000000000001011000000000001                                                              
                                                                                 1000001                      1100000000000000000000001001                                                              
                                                                                 10000011 11                 100000000000000000000000000001                                                             
                                                                     11          100000001001               1100000000000000000000000000001                        1   111                              
                                                                    1001        1000000000001              10000000000000000000000000000001                       10111000111                           
                                                                    1001     1  1000000010001111         111000000000000000000000000000001                       1100000100001                          
                                                                   11001   11011 1100000101110001111   110000000000000000000000000000000001                     10000000000001                          
                                                                  100001  10000010000000001 1000100011100000000000000000000000000000000011                      10000000200001                          
                                                                 100000111100000000000000111 100000000000000000000000000000000000000000001                       1000000000100111111                    
                                                                  1001000000000000000000010011000000000000000000000000000000000000000000001                      1000000000000000000111                 
                                                                  1000001000010000000000010000010000000000000000000000000000000000000000001                       1100000200001111100001     111        
                                                                   100200100000000000000010000001000000000000000000000000000000000000000001            11  111     100000000000011000001 11110001       
                                                                   100000000001000000000000000011000000000000000000000000000000110000000001          1100110001    1000000000001 10000011000001001      
                                                                   100000001111000000000000000000002000000000000000000000000000000000000001         10000000001  11 1000000000001 100000000011 1001     
                                                                   1000000001100000000100000000020000000000000000000000101111000000000000001       10000000001  10010000000000001  1101000001   1001    
                                                                   100010000000000000000000000000000000000000000000000011  100010000000000001     10000001000111000110000001000011   1100001   1000011  
                                                                  1000000001100000000000000000000000000000000000000000111110000000000002000001    101001000000011001000000011000001 11100001  110000101 
                         1                                        100000100000000000010000000000001000000000000000000110000000000100000000001     101000001000001000000000001110000100000001 10000000001
                        101                                       1000100000000000011 11100000000000000000000000000000000001000000000000000001     11000000010000001100000001100000000000001100000100001
                     111101                                      1110010000002000011    10000000001100010000000000000000000000000001000000001011   10000010000000000100000000000010000000000000000100101
                    10000001                                   1100000000000100000001 111000000001 1000100000001000000000100000000000000000010001 110000000000010110100000000000000000000010000000000001
                    1000001                                  110000000000000100000001100000000001 1000000000000000000000000000001111110000010000010000000000001 1 1010000000000000000000000000000011111 
                     1100001                                100000000000000000000000001000000001   1100000000000000000000000000011   101000000000100000000001101  1000000001000000000000000000000001    
                       10011                                100000000000020000001000000000000001    1000000000000000000100020000001  100000001100001000000000001 100001111100000000000000000000000001   
                    1 1000001                               100000000000000000001000000000000001    1001011000111020000000000000001 1 1111011  11001110000000001 100001 110000000000000000000000111001  
                   101000100111                             1000000000000000000000000000000001001    11 1  111   110010010000000000101    1    10001  1000000000111110110000000000000000000000001 1001  
                   1000000000001                            10000000000000000000000000000000000001                 10000000000000000001        10001   1000000000011101 1000000000000000000000001 101   
                  11000000110001                            10000110000000000011001110000001000001                 10000000001000001101        1011    1010000000010101  1101000000000000110000111101   
                 10000000000011                              11000100000000000110000000001110000001                10001100110000001101         1       110000000010001 10100001000011100000000000001   
                  10000100011                                  110000100000000000001000001  100011                  1001 10001000001101  11             10000000000001  1000000000001110010011111111    
                  100011011                                      100000020000000000000111   10001                    11  10000000001001 10011          100000000000001   1000011000110101 11            
                  1001 1001                                      100000000000000011111       1101                        10000000000000110000111       1000000000000011 100000010000000001              
                  100111001                                     1000000000000010001            1                         10000000100001 100000001      1000100000000000110000011000000111               
                  100100101                                    1000000001000001111                                      100000000000001 1000000001      1100000000000001100000000010001                 
              1111110000001                                    1000000000000001                                          100100001000001100000001        100000000000000000000000000001                 
            1100000010000001                                   1000000010000001                                           10111110000001000000001        100000000000000000000000000011                 
           100000001000000001                                 10000200010000001                                            1     1000000000000011111    10000000000000010000000000110001                
            11000001000000001                                 10000000000000001                                                  10000000000000000001    1000000000000000000000000110001                
            100000110010000001            1                   10000000000000001                                                   110000000000001100111  10011000000000000000000100000001               
            110000000010000001           101111    1 1111     1000000000000011                                                     100000000010010000001 10011000000000000000010111000001               
           100000000001000111          111000001  10100001   100000000000000001                                                    1000000000000100000001 11  100000000000000001  100101                
           1000011100010001           100000111   10000001   1001000000000000001                                                   100010000000000000011      10000000000000000111100001                
           10001   11000011 1      1110000001    1000010011  10010000000000000001                                                 10000100100000111111         100000100000000000010001                 
      11  100001    1100000101    1000000001     10000000001 10110000000000000001                                                100000000001011              100110000001000011000001                  
     10011101111   10000100001     10000001 111110000011000011001000110000001111                                                  1100000000001               10000000000000011100011                   
 1  1000001000001  10110000001    1000000011000010001010000000001111 1000001                                                     10010000000001                10000000000100001111                     
101  10011 110001 10000011101  1  100000000100000000000000000011     100001                                                      1000100000001                 1000000001110001                         
10011000011000001 10011110001 10110000000000001000000000000011       10011                                                       100000000011                  101100011  10001                         
1000000000000001   11   1011  1000010000000001 12010000000001       10001                                                       11100000001                     1 10001    10001                        
1000000000000001        1001  1000000000000001 100100000000001       10001                                                    1100000001101                       110001   1000011                      
10000000100000111111    1001  10000000000000011100100001101101      10001                                                    100010000000001111                  10000001   111000111                   
100000000000000000001   10011100000000110000000000111000001101    1110001                                                    1000000000000000001               1110000001     10000001                  
 1000100000000100000011 10000001111000000001010000010000000001   1000001                                                      11100000000000011               10000001011     101112011                 
 101110000000000000000011011111  100000000001000000100100000001   100021                                                       10000000001111                  11000110001     110000001                
10010000000001000000000011        11100000001000011100100011101   100001                                                       10000000001                      1011 100011     10000001                
10000000000000000000000000111       10000111100001 100101010001    11101                                                        11101000001                      1   1000001    1000111                 
1000000000000000000000000010011    100001111101001 10010110011        1                                                            1100001                          10000001 1   100001                 
10010001000000000000000000000001  111001000010110110000011001                                                                       100001                          10000000101  100001                 
101100000001000000000000000000001100000000010011000000001 101                                                                       10111                            100000100111000101                 
 1  1020011 100010000001110000001100000001110011110000101 101                                                                        1                                11100100100001 1                  
   1110001 100000000000110010000000000000110001000000001 1001                                                                                                           1001000000001                   
  1000001   11000000000100110000000000000000001100001011 101                                                                                                             10100000001                    
  1000001    100000011000010010000000000110000110000000011001                                                                                                            10001100001                    
   100001    1100000010011100000010000000000021100000000000001                                                                                                            111 100001                    
 1100001    101001000101  1100001 100001100101  1000000100001                                                                                                                 10111                     
1000001    100101100011 11000111   1101 100001   11000110101                                                                                                                   1                        
 100001   100000000001 1000001       1  101101     111 10001                                                                                                                                            
100011   100000100001 100000001 111111  101 1          10001                                                                                                                                            
100001   100100000000111100011110000001 101             1001                                                                                                                                            
 100001111111010011111000000100100100011101              11                                                                                                                                             
 1000000001110111    10000100001001000000001                                                                                                                                                            
  1110000000101      10011 10000011011000001                                                                                                                                                            
    10001000001     110001 100001 10000100001                                                                                                                                                           
   1000001000001   100001 100011  10000111101                                                                                                                                                           
    1100000000001 1001001111001    1111   101                                                                                                                                                           
      100000001011100000000111             1                                                                                                                                                            
       111000000100000000001                                                                                                                                                                            
     11 10000000000010000001                                                                                                                                                                            
    1001000000000000000100001                                                                                                                                                                           
   10000000002000000000000001                                                                                                                                                                           
   12000000000000000000000001                                                                                                                                                                           
    11000000100000000001000001                                                                                                                                                                          
     1000000000001100000100001                                                                                                                                                                          
      10001010001111000000011                                                                                                                                                                           
    110000000000000000111001                                                                                                                                                                            
   100000000000000000001 11                                                                                                                                                                             
   100000000000000000001                                                                                                                                                                                
   12000000000000000011                                                                                                                                                                                 
  100000010000000000001                                                                                                                                                                                 
  1000111 1100000000001111                                                                                                                                                                              
  1001      101100100000001                                                                                                                                                                             
 1001        1 100110000001                                                                                                                                                                             
 10001         100000000001                                                                                                                                                                             
  1001        10000000000001                                                                                                                                                                            
 11001         1000000000001                                                                                                                                                                            
10001        11000000000101                                                                                                                                                                             
10001       100000010000101                                                                                                                                                                             
100001  11   10000000000001                                                                                                                                                                             
10001111001   100010000011                                                                                                                                                                              
100110000011   111100001                                                                                                                                                                                
1000000000001     100001                                                                                                                                                                                
 1111200000001    100001                                                                                                                                                                                
   1000000001 1    1011                                                                                                                                                                                 
   1000000011101    1                                                                                                                                                                                   
   1000001010001                                                                                                                                                                                        
 111000000000001                                                                                                                                                                                        
100001000000001                                                                                                                                                                                         
100000000000001                                                                                                                                                                                         
 11000000000001                                                                                                                                                                                         
1001000000000001                                                                                                                                                                                        
1000001011100001                                                                                                                                                                                        
10001001  10011                                                                                                                                                                                         
1001 11    11               1                                                                                                                                                                           
101     11               11101                                                                                                                                                                          
1001   1001             100001                                                                                                                                                                          
100011 1001              10001                                                                                                                                                                          
100000110001             10001                                                                                                                                                                          
1001100000001  111       100001                                                                                                                                                                         
 11  10000001110001      100101                                                                                                                                                                         
    10000000001011        1000011                                                                                                                                                                       
    10000000000011    1  110000001                                                                                                                                                                      
  111000111111000011110110100011001                                                                                                                                                                     
 1000011     100100000000000000101                                                                                                                                                                      
10000011      11 100100000010000001                                                                                                                                                                     
100000001         111000000000100001                                                                                                                                                                    
 11000001           100000000001001                                                                                                                                                                     
100000001            1111111000111                                                                                                                                                                      
100010001                  1001                                                                                                                                                                         
10000001                   1000111                                                                                                                                                                      
1000001                    10001001                                                                                                                                                                     
100011                      1000001                                                                                                                                                                     
1000011                      110011                                                                                                                                                                     
10000001                     1100001                                                                                                                                                                    
 100011                     10011001                                                                                                                                                                    
100001                      10E0001                                                                                                                                                                     
10001                       1000001                                                                                                                                                                     
100001                      1001001                                                                                                                                                                     
100001                      1011001                                                                                                                                                                     
1000001                      1  11                                                                                                                                                                      
100001                                                                                                                                                                                                  
 1111