R 10000 500000
NO textures/file1.xpm
EA textures/file2.xpm
SO textures/file3.xpm
WE textures/wood.png
S textures/pixil-frame-0.png

C 0,0,0
F 0,0,0


        1111111111111111111111111
        1000000000110000000000001111111111111111111111
        1011000001110000002222000000000000000000000001
        1001000000000000000000001111111111111111111101
111111111011000001110000000000001                  101
100000000011000001110111111111111                  101
11110111111111011100000000001                      101
11110111111111011101010010001                      001
11000000110101011100000010001                      101
10002000000000001100000010001                      101
100000000000000011010100100011111111111111111111111101
11000001110101011111011110N000000000000000000000000001
11110111 1110101 1011110100011111111111111111111111111
11111111 1111111 111111111111